B-Side Wins Again featuring Chuck D	DJ Spooky and Dave Lombardo
Barrier Break	Dieselboy + Kaos
Blood and Thunder	Mastodon
Blinded In Chains	Avenged Sevenfold
Broken Sword	Evol Intent, Mayhem & Thinktank
Decadence	Disturbed
Do Ya Thang	T.I. Presents The P$C
Feed The Addiction	Ils
Feels Just Like It Should (Timo Maas Remix)	Jamiroquai
Fired Up	Hush
Hand of Blood	Bullet For My Valentine
I Am Rock	Rock
In A Hood Near You	Suni Clay
Let's Move	The Perceptionists
Most Wanted Mash Up	Paul Linford and Chris Vrenna
Nine Thou (Superstars Remix)	Styles of Beyond
One Good Reason (Instrumental)	Celldweller
Sets Go Up	Juvenile
Shapeshifter	Celldweller featuring Styles Of Beyond
Skinnyman	Static-X
Tao of the Machine (Scott Humphreyâ€™s Remix)	The Roots and BT
The Mann	Paul Linford and Chris Vrenna
Tilted	Lupe Fiasco
We Control	Hyper
You Must Follow (Evol Intent VIP)	Stratus
You'll Be Under My Wheels	The Prodigy